%%%%%%%%%%%%%%%%%%%%%%%%%%%%%%%%%%%%%
%                                   %
%                       P           %
%                                   %
%   %                      % %      %
%    %                   % % %      %
%     %               % %           %
%      %            % %             %
%       %          % %              %
%        %        % %               %
%         %     %                   %
%          %  %                     %
%          %                        %
%    %                              %
%     %   %       G G G             %
%      % %                          %
%      %          %           %     %
%     %        %  %         %       %
%      %      %    %       %        %
%       %    %      %     %         %
%        %   %        %   %         %
%.         %           %            %
%%%%%%%%%%%%%%%%%%%%%%%%%%%%%%%%%%%%%