%%%%%%%%%%%%%%%%%%%%%
%.. P  %%%%%        %
%..  ... % ..   GGGG%
%..  ... %...   %%%%%
%..    ..%.         %
%%%% ... %...   ..  %
%..  ... %%%%%      %
%..   %%%%..      ..%
%.. o  ..%..      ..%
%..  ... % ...  ... %
%  %%%.. %%%..  ... %
%..    .. ..      ..%
%..  ...   ...  ... %
%..  ... % ...%% ...%
%..    ..%..  %%  ..%
%..  %%%%%..  %%  ..%
%.. o  ..%..  %%  ..%
%..  ... % ...  ... %
%..  ... % ...  ... %
%%%%%%%%%%%%%%%%%%%%%