%%%%%%%%%%%%%%
%      %  G  %
%      %     %
%      %     %
%            %
%P     %     %
%%%%%%%%%%%%%%
