%%%%%%%%%%%%%%%%%%%%%%%%%
%.. P  ....      ....   %
%..  ...  ...  ...  ... %
%..  ...  ...  %%%%%%%% %
%..    ....    % ...  G %
%..  ...  ...  %%%%%%%% %
%..  ...  ...  ...  ... %
%..    ....      ....  o%
%%%%%%%%%%%%%%%%%%%%%%%%%