%%%%%%%%%%%%%%%%%%%%%%%%%%%%%%%%%%%%%%%%%%%%%%%%%%%%%%%%%%%%%%%%
%..   ....      .   ....      .... ...   ..   ....      ....   %
%..   ....      ....  ..      ....   ..   .   ....      ....   %
%..   ....      ....   ..     ....   ..   .... ...      ....   %
%..   ....      ....   ..     ....   ..   .... ...      ....   %
%..   ....      ....   ..     ....   ..   ... ....      %.%.   %
%..   ....      ....   ..   ......   ..   ....      .... G ..  %
%..   ....      ....   ..   ....     ..   ....  ..      %.%.   %
%..   ....      ....   ..   ....     ..   ..  ....      ....   %
%..   ....      ....   ..   ....      ..  .... ...      ....   %
%..   ....      ....   ..   ....      ....  ..          ....   %
%..   ....      ....   ..   ....      ....   ..     ....   .   %
%..   ....      ....   ..   ....      ....   ..     ....   .   %
%..   ....   P  ....   ..   ....      ....   ..     ....   .   %
%..   ....      ....   ..   ....      ....   ..     ....   .   %
%..   ....      ....   ..   ....      ....   ..     ....   .   %
%..   ....      ....   ..   ....      ....   .      ....   .   %
%..   ....      ....   ..   ....      ....   .      ....  ..   %
%..   ....      ....   ..   ....      ....   .      ....   .   %
%..   ....      ....   ..   ....      ....   ..     ....   .   %
%..   ....      ....   ..   ....      ....   ..     ....   .   %
%..   ....      ....   ..   ....      ....   ..     ....  ..   %
%..   ....      ....   ..   ....      ....   ..      .   .. .  %
%..   ....      ....   ..   ....      ....   ..   .... .   .   %
%..   ....      ....   ..   ....      ....   ..   ....  ....   %
%..   ....      ....   ..   ....      ....   ..   ......   .   %
%..   ....      ....   ..   ....      ....   ..   ......   .   %
%..   ....      ....   ..   ....      ....   ..   ......   .   %
%..   ....      ....   ..   ....      ....   ..   ......   .   %
%..   ....      ....   ..   ....      ....   ..   ......   .   %
%..   ....      ....   ..   ....      ....   ..   ......   .   %
%..   ....      ....   ..   ....      ....   ..   .... .   .   %
%..   ....      ....   ..   ....      ....   ..   ......   .   %
%..   ....      ....   ..   ....      ....   ..   ....     .   %
%%%%%%%%%%%%%%%%%%%%%%%%%%%%%%%%%%%%%%%%%%%%%%%%%%%%%%%%%%%%%%%%